60
2,1
9,6
2,2,2,2,2,2,2,2,2,2,2,2
2,2,11,9,1,1,1,1,1,1,2,2
2,2,1,4,1,1,8,9,1,1,2,2
2,2,1,4,3,0,5,3,5,1,2,2
2,2,1,5,3,5,4,1,4,4,2,2
2,2,1,7,3,6,1,3,1,1,2,2
2,2,1,1,1,1,1,1,7,13,2,2
2,2,2,2,2,2,2,2,2,2,2,2
