180
1,1
10,6
2,2,2,2,2,2,2,2,2,2,2,2
2,12,2,1,1,3,1,1,4,1,1,2
2,4,1,8,5,3,1,9,4,1,1,2
2,7,3,4,1,16,9,3,4,1,1,2
2,4,3,0,1,1,3,4,15,5,4,2
2,1,8,1,18,3,1,6,7,1,9,2
2,7,6,1,1,1,3,1,1,1,10,2
2,2,2,2,2,2,2,2,2,2,2,2
