60
1,1
10,6
2,2,2,2,2,2,2,2,2,2,2,2
2,12,1,1,1,1,1,1,1,1,1,2
2,4,0,1,1,8,3,3,9,4,1,2
2,7,3,5,3,16,3,9,4,4,1,2
2,1,1,4,1,4,1,4,15,4,1,2
2,8,9,18,3,7,3,6,7,5,9,2
2,7,6,1,1,1,1,1,1,1,10,2
2,2,2,2,2,2,2,2,2,2,2,2
