30
2,2
9,5
2,2,2,2,2,2,2,2,2,2,2,2
2,2,2,2,2,2,2,2,2,2,2,2
2,2,12,1,1,1,1,1,1,1,2,2
2,2,7,3,3,9,3,1,1,1,2,2
2,2,1,1,0,7,7,3,3,9,2,2
2,2,1,1,1,1,1,1,1,10,2,2
2,2,2,2,2,2,2,2,2,2,2,2
2,2,2,2,2,2,2,2,2,2,2,2
