30
3,1
8,6
2,2,2,2,2,2,2,2,2,2,2,2
2,2,2,12,0,1,1,1,1,2,2,2
2,2,2,4,1,1,1,1,1,2,2,2
2,2,2,18,3,9,1,1,1,2,2,2
2,2,2,1,1,4,1,1,1,2,2,2
2,2,2,1,1,4,1,1,1,2,2,2
2,2,2,1,1,18,3,3,13,2,2,2
2,2,2,2,2,2,2,2,2,2,2,2