2,2,2,2,2,2,2,2,2,2,2,2
2,2,2,12,0,1,1,1,1,2,2,2
2,2,2,4,1,1,1,1,1,2,2,2
2,2,2,4,1,1,1,1,1,2,2,2
2,2,2,4,1,1,1,1,1,2,2,2
2,2,2,4,1,1,1,1,1,2,2,2
2,2,2,7,3,3,3,3,13,2,2,2
2,2,2,2,2,2,2,2,2,2,2,2